11111111111111
10C00C00000001
100000E0C00001
100100000000P1
11111111111111