111111111111111111
10C0PC000000000001
100000E00000000001
10000000C000000001
111111111111111111