111111111111
10000P000E01
1000C0000C01
111111111111