111111111
1C00000P1
1000E0C01
1C0000001
111111111