111111111111111
1E00000000000P1
10CCCC00C000001
10000C00C0C0001
10000C00C0C0001
10CCCC00CCCCC01
10C0000000C0001
10C0000000C0001
10CCCC0000C0001
100000000000001
111111111111111