1111111111111
1E000C00C00C1
1010101C10101
1010101C10101
1P0C00C0000C1
1111111111111