1111111111111
1EC00C00000C1
1010101C10101
1010101C10101
1P0C0C00000C1
1111111111111