11111111111111111111
100000000000000000E1
10CCCC00C00000000001
10C00C00C00000000001
10000C00C0C000000001
10CCCC00CCCCC0000001
10C0000000C000000001
10C0000000C000000001
10CCCC0000C000000001
100000000000000000P1
11111111111111111111